15 10
. . # # # # # # # #
# . . . . . . # # #
# # . # # M # # # #
# # . # # T # # # #
# # . . . . . . # #
# # # # # # # M # #
# # # . . . . . # #
# # # . # # # . # #
# # T . . # . . . #
# # # . # # # # # #
# # # . # # # M # #
# . # . . . . . # #
# . # . # # # . # #
# . . . . . . . . #
# # # . # # # # . .
3
11
16
13
10
shtit
12
15
16
20
bariera
10
18
12
20
zashtitna cherupak
2
Spell
30
ogun
Armor
10
stena