10 10
. . # # # # # # # #
# . . . . . . # # #
# # . # # M # # # #
# # . # # T # # # #
# # . . . . . . # #
# # # # # # # M # #
# # # . . . . . # #
# # # . # # # . # #
# # T . . . . . . .
# # # . # # # # # .
2
25
25
30
15
Lyspite
25
25
30
15
Lyspite
2
Spell
30
ogun
Armor
10
stena
